####################
#                  #
#  H               #
#                  #
#                  #
#                  #
#                  #
#                  #
#                  #
#        #         #
#                  #
#                  #
#   F              #
#                  #
#                  #
#                  #
#         R        #
#                  #
#                  #
####################