####################
#    #   #         #
#  H #   #         #
####     #         #
#                  #
# #### ### ####    #
#       #          #
#  #     #   #     #
#  #     #   #     #
#  #     ##  # ### #
#  #         #     #
#  ###  ## ###     #
#   F              #
#                  #
#           RT     #
#                  #
#         R        #
#                  #
#                  #
####################