###########################
#    #   #                #
#  H #   #     C          #
####     #                #
#                         #
# #### ### ####           #
#       #                 #
#  #     #   #            #
#  #     #   #            #
#  #     ##  # ###        #
#  #         #            #
#  ###  ## ###            #
#   F                     #
#                         #
#           RT            #
#                         #
#         R               #
#                         #
#                         #
###########################