##########################
#H                       #
#           F      R     #
#      R                 #
#                       0#
##########################
#4          F           1#
#       #########        #
#########   # F #    F   #
# F       #   # #       0#
##########################
#                        #
#                        #
#TT                      #
#5T                      #
##########################
#2  T                   5#
#   T F             F    #
#TTTT F             F    #
#4                      1#
##########################
#2                       #
#                 FFF    #
#                 FFF    #
#                       C#
##########################
