##########################
#H  f#g  e#   f#   i#    #
W    W    W    W    #    #
W    W    W    W    # R  #
#e  a#r   #g  h#   h#    #
##########################
#   q#b  w#   m#j   #j   #
#    #    #    #    #    #
#    #    #    #    # R  #
#    #   a#z  w#   k#i   #
##########################
#t  q#o   #b  x#r   #v  t#
#    #    #    #    #    #
#    #    #    #    # R  #
#    #    #   c#v  s#   s#
##########################
#    #k  n#u   #c  y#z   #
#    #    #    #    #    #
#    #    #    #    # R  #
#   p#   l#   y#u  d#    #
##########################
#x   #n  m#    #    #d   #
#    #    #    #    #    #
#    #    #    #    # R  #
#    #o  p#    #    #   C#
##########################
