###############
#H            #
#             #
#             #
#    S        #
#    SR       #
#    S        #
#           F #
#             #
###############