###############
#H            #
#             #
#             #
#    S        #
#    S        #
#    S        #
#             #
#             #
###############